XXXXXXXXXXXXXXXX
X  OOOOOOOOOO  X
X ##O##OO##O## X
XO#OOOOOOOOOO#OX
XOOO#O#OO#O#OOOX
XO#OOO#OO#OOO#OX
XO#O##OOOO##O#OX
XOOOOOO##OOOOOOX
XOOOOOO##OOOOOOX
XO#O##OOOO##O#OX
XO#OOO#OO#OOO#OX
XOOO#O#OO#O#OOOX
XO#OOOOOOOOOO#OX
X ##O##OO##O## X
X  OOOOOOOOOO  X
XXXXXXXXXXXXXXXX